10
S*#****#..
#*#*##*##.
#***#**.#.
#.#.#*###.
...#.**#..
##.###*#.#
#..#..*#.#
##.#.###..
...#.#....
.##....#.G