30
..............................
..............................
..#####.##....................
..#.#.#..#....................
..#...#..#....................
..#...#.###...................
..............................
..............................
..............................
..............................
..............................
..............................
..............................
..............................
..............................
##############################
##############################
##############################
#############################.
##############################
##S.....####...###...........#
####....####....##....###.....
#####.#.####.........#####..##
#####...#......##....####..###
###...........####...........#
####....#.....###....####..###
##.....###..........######...G
##############################
##############################
##############################
