30
..............................
..............................
..............................
..............................
.........######...............
........##########............
........###..#####............
.......#.#...#....##..........
......#..#...S.##..##.........
......#.........##..#.........
......##.#.......##...........
........##......#..#..........
........#########.##..........
.................##...........
........########..............
.......#..#.....#.............
.....##...#..#...##...........
.....#....#..#...#.#..........
....###...####..#..#..........
....#...............#.........
....#..#.#.....##..#..........
....#..#.#......#..#..........
.....###G#......####..........
........##.......#............
......###...##..###...........
.....####..#..#.####..........
....#......#..#....#..........
.##.#.#####....######.........
.##.........##................
##############################
