10
S.......#.
#.......#.
######..#.
.##..#..#.
..#..#..#.
.....##.#.
.....#..#.
.......##.
......#...
......#..G