8
S....#..
..####.#
...#...#
.##.#.#.
........
##.#.#.#
...#.#..
.####..G
