45
#############################################
#############################################
.#...#...#.#...#.#...#.#...#...#...#.#.......
.#.#####.#.#.###.#.###.###.#.###.###.#.######
...#.#.....#.#.#.#...#.....#...#.......#.....
##.#.###.###.#.#.#.#######.#.#####.#####.####
.#.#...#.......#.................#..........G
.#.###.#.#.###########.###########.###.##.###
.....#.#.#...#...#.#.....#.#...#.....#..#....
##.###.#.#####.###.#.#####.#.###.##########.#
.....#.........#.#.....#.......#..........#.#
####.###.#######.###.###.#######.############
...#.......#.#.....#...#.#.....#.....#.......
##.#.#.#.###.###.###.###.#.#.#######...##.###
.....#.#.....#...#.#.#.....#...#...#.#..#.#..
####.#####.#####.#.#.###.#.###.###.#.#.######
.....#.#.#...#.#...#.....#...#.#.#.#.#...#.#.
####.#.#.#####.#.#####.#########.#.#.#.###.#.
...#...#...#.#.#.#.....#...#.....#.#.#.......
####.###.###.#.#.###.###.#.###.###.#.#.###.#.
...#.#...#.#...#.#.#...#.#.#.#.#.........#.#.
##.#.#.###.#.###.#.#.###.###.#.#####.###.#.#.
.#...#.#.#.#.#...#.............#.......#.#.#.
.###.#.#.#.#.###.###.#######.#####.#.###.###.
...#.#...#.#.#.#.#.#...#.#.#.#...#.#.#.#.#.#.
##.#.#.###.#.#.#.#.#.###.#.###.###.###.###.##
...#.......#...#.#...#.#.#.#...#.............
##.#.#######.###.#.###.#.#.#.###.#####.######
.......#.#.#...#....#......#...#...#.#.....#.
##.#####.#.#.###.#########.#.###.###.#####.#.
.#...#.#...#.#.............#...#.......#...#.
.#.###.###.#.#.#########.#.#.###.#.#######...
.#...........#.........#.#.......#.#...#...##
.#####.###.###.#####.###.#.#.#.#.###.#####.#.
.#.#...#.#.#.#.....#...#.#.#.#.#.......#.#.#.
.#.#####.#.#.#.#######.#.#.#.#######.###.#.#.
.#.#...#.....#...#.#...#.#.#.......#.....#.#.
.#.###.#.#.#.#.###.###.#.#.###.###.#.#.###.#.
.#...#...#.#.........#.#.#.#.....#.#.#.......
.###.#.###.#.#.#.###.#######.#.###.#.###.####
...#.#...#.#.#.#...#.......#.#...#.#...#.....
##.#.#.#####.#.#########.#####.#.#.#####.####
.......#.#.#.#.........#.....#.#.#.....#.....
.#####.#.#.#########.#.#####.#########.#.####
S....#.............#.#.....#.......#...#.....
