30
S......#......................
##.....##.....................
.###....##....................
...##.....#...................
....##.....#..................
.....##.....##................
......#.......#...............
......##......#...............
.......#.......##.............
.......#.........#............
........#........##...........
........#.........##..........
.........#.........##.........
.........#..........#.........
.........#...........#........
..........#..........#........
###.#......#.........##.......
#....##....#..........#......G
#.....#.....##........##......
......##.....#.........#......
#......##.....#.........#.....
#.......##.....#........##....
##.......#.....####......#....
.#........#.......##.....#....
..#........#.............#....
..##........##...........#....
...##........######.....##....
....###............######.....
.......##.....................
..............................