45
#############################################
#############################################
.#...#...#.#...#.#...#.#...#...#...#.........
.#.#####.#.#.###.#.###.###.#.###.###.........
...#.#.....#.#.#.#...#.....#.................
##.#.###.###.#.#.#.#######.#.#####...........
.#.#...#.......#.................#...........
.#.###.#.#.###########.###########...........
.....#.#.#...#...#.#.....#.#...#.............
##.###.#.#####.###.#.#####.#.###.............
.....#.........#.#.....#.......#.............
####.###.#######.###.###.#######.............
...#.......#.#.....#...#.#.....#.............
##.#.#.#.###.###.###.###.#.#.#######.........
.....#.#.....#...#.#.#.....#...#...#.#.......
####.#####.#####.#.#.###.#.###.###.#.#.......
.....#.#.#...#.#...#.....#...#.#.#.#.#.......
####.#.#.#####.#.#####.#########.#.#.#.......
...#...#...#.#.#.#.....#...#.....#.#.#.......
####.###.###.#.#.###.###.#.###.###.#.#.###...
...#.#...#.#...#.#.#...#.#G#.#.#.........#...
##.#.#.###.#.###.#.#.###.###.#.#####.###.#...
.#...#.#.#.#.#...#.............#.......#.#.#.
.###.#.#.#.#.###.###.#######.#####.#.###.###.
...#.#...#.#.#.#.#.#...#.#.#.#...#.#.#.#.#.#.
##.#.#.###.#.#.#.#.#.###.#.###.###.###.###.##
...#.......#...#.#...#.#.#.#...#.............
##.#.#######.###.#.###.#.#.#.###.#####.######
.......#.#.#...#....#......#...#...#.#.....#.
##.#####.#.#.###.#########.#.###.###.#####.#.
.#...#.#...#.#.............#...#.......#.....
.#.###.###.#.#.#########.#.#.###.#.#######...
.#...........#.........#.#.......#.#...#.....
.#####.###.###.#####.###.#.#.#.#.###.#####...
.#.#...#.#.#.#.....#...#.#.#.#.#.......#.#...
.#.#####.#.#.#.#######.#.#.#.#######.###.#...
.#.#...#.....#...#.#...#.#.#.......#.....#...
.#.###.#.#.#.#.###.###.#.#.###.###.#.#.###...
.#...#...#.#.........#.#.#.#.....#.#.#.......
.###.#.###.#.#.#.###.#######.#.###.#.###.....
...#.#...#.#.#.#...#.......#.#...#.#...#.....
##.#.#.#####.#.#########.#####.#.#.#####.....
.......#.#.#.#.........#.....#.#.#.....#.....
.#####.#.#.#########.#.#####.#########.#.....
S....#.............#.#.....#.......#...#.....
