20
S..#...#...#.......#
.#.#.#.#.#.#.###..#.
.....#.#.#...#...#..
##.##..#..####..#...
...#..#.#.#....#..#.
.##.....#.#.#.#...#.
....#.#...#..#..###.
####...#.#..#.#.#...
....##..#..#....#.##
.##....#..#..####...
...####.....#....##.
##.#....#..#..##....
...#.#.#..#.#...####
.###..#..#...#.#....
.#...#.#.#.#.....##.
.#..#....#.#.#..#...
...#..####..#..##.##
..#...#...#.#.#.....
.#..###.#.#.#.#.#.#.
#.......#...#...#..G
