19
...#...#...#...#...
.#.#.#.#.#.#.#.#.#.
.#.#.#.#.#.#.#.#.#.
.#...#.#.#.#.#...#.
.#####.#.#.#.#####.
.....#.#.#.#.#.....
####.#.#.###.#.####
...#.#.#...#.#.#...
.#.#.#.#.#.#.#.#.#.
G#...#...#...#...#S
.#.#.#.#.#.#.#.#.#.
...#.#.#...#.#.#...
####.#.###.#.#.####
.....#.#.#.#.#.....
.#####.#.#.#.#####.
.#...#.#.#.#.#...#.
.#.#.#.#.#.#.#.#.#.
.#.#.#.#.#.#.#.#.#.
...#...#...#...#...
