22
S.####################
#.#.......##..........
#.#.......##...######.
#.#.#####.##.#..#####.
#.#.#####....#..#.....
#.#.######.##...#.####
#.#.######.#...##.....
#.#.######.#..#...###.
#.#.######..#.###.##..
#.#.######..#..##.##.#
#.#.######..##.#..##..
#.#.######..##.#.###.#
#.#.#####....#.#.#####
#.#.####.....#.#.....G
#.#...#..####..#.#####
#.####..#.....##...#..
#.####.#......##...##.
#....#.######.#...###.
####.#......#.#.###...
.....#......#...##....
.#########..#####.#...
......................
