10
S.........
#########.
..........
.#########
..........
#########.
..........
.#########
..........
#########G