10
G.....#...
..##.#..#.
#..#...##.
...##.#...
.#....#.##
..#.###...
#.#...###.
..###...#.
.##...###.
....#....S
