30
######################..######
#S....#.#....#.....####..###..
###.###.#.##.#.#.#.#####.#....
#.#.###.#....#.###.#...###.#.#
#.#.###.#.##.#.#.#.#.#.#.#.#.#
#.#.......##...#.#...#.####..#
######################.#.....#
...#########...........##..###
.#.###...#...##############..#
.#.###.###.###....#######...##
.#.###...#..##.##..#.#....##.#
.#.###.###.###.###.#.#.####..#
.#...........#.#.#.#.#..#...##
.#############.#.#.#.##..#####
.#############.###.#####.....#
...................##...####.#
#.###################.#.####.#
#....##########.....###....#.#
#.##.##########.###.######.#.#
#........#....#.##..##..####..
#.####.#.#.##.#.###..##.###.#.
#.####.#....#...####..#...#...
#.####...####.#######.######.#
#....######...#######.########
####..##########....#..##..###
#####..########..##.##.###....
#...##..........###.#...######
#..#######..######...##.....##
##.....###.##..##.##..#####.G#
####..###.#######..##.##..####
