13
...#...#...#S
.#.#.#.#.#.#.
.#...#.#.#...
.#####...####
.....#.#...#.
####.#.###.#.
.....#.....#.
.###.###.#.#.
...#.....#...
##.##.##.####
.#.#...#.....
...#.#.#####.
G#...#.......
