20
.#......#........#.G
.#.####.#.######.#..
.#..#...#....#.#.##.
.##.#.######.#......
....#...#.....#.####
.####.#.#.#.#.#...#.
.#...##.#.#.#####.#.
.#.#.##...#.#.....#.
...#.######....#.##.
####.#.#...###.#....
...#.....#..#..####.
.#.#.##.###.#.#...#.
.#.#......#.#...#...
.#.######.#.###.####
.#.#....#.#...#.#...
...##.#.#.#.#.#.#.#.
.#.#..#.#.#.#.....#.
.#..#.#...#.#######.
..#.#.#.####...#....
S.....#......#...#..
