20
.#......#........#.S
.#.####.#.######.#..
.#..#...#....#.#.##.
.##.#.######.#......
....#...#.....#.####
.####.#.#.#.#.#...#.
.#...##.#.#.#####.#.
.#.#.##...#.#.....#.
...#.######....#.##.
####.#.#...###.#....
...#.....#..#..####.
.#.####.###.#.#...#.
.#........#.#...#...
...######.#.###.####
.###....#.#...#.#...
...##.#.#.#.#.#.#.#.
.#.#..#.#.#.#.....#.
.#..#.#...#.#######.
..#.#.#.####...#....
G#....#......#...#..
