15
......##..#...#
.###.#...#..#..
.#.....#.#.###.
.#.##.#..#..#..
....#......#...
.##.####..#..#.
.#..#...#...#..
.#.####..###..#
....#.#......#.
.####.#.###.##.
...#..#...#.#..
##.##.#.#.#.###
...#....#.#....
.###.####.#.#.#
G#...#....##..S
