19
S.#.#.#.#.##..##...
......#.#..##..#..#
##.##.#.........#.#
........#.####.#..#
####..#........#...
......#.#..#..##..#
#.....#..#.#.##...#
#.##..####.#..#....
#...###..#.#.##...#
.#.......#.#....###
##.......#...##....
...#...#.#.#...####
.#..##.#...#..##...
.#......##......###
###.....#..#.##....
.#.##..#...#.....#.
.....#.#.....#...#.
.###...#...#....##.
G#.........#.#.##..
