64
.............................#G....############....#...#...#...#
.#############################.###...............#.#.#.#.#...##.
.#.....#...###....#....#...#...#.############.##.#.#.#.####.#...
.#.##.#..#..#..##.#.##...#.#.##..#...#......#.#..#.#.#......#.#.
.#..#...#..#..#...#..#####.#.#..####.######.#...#..#.########.#.
.##.##.#..#..#..#..#...#.....##....#..#...#.###.#.##...#......#.
.#..#...#...#..#.#.#.#.#.#####.###.##.###.#.#.#.#..#.#.##.#####.
.#.####..###..#...##.#...#.......#......#.#.#.#..#...#.#...#....
.#....#......#..#.....##...#...#.###.##.#.#....#..###..#.#......
.####.#.###.##.######..#######.#...#..#...####..#..#..#..######.
.#....#...#.#.....#..#..#......###..#...#.....#..#.#.#..#.....#.
.#.##.#.#.#.#####.#.###.#.###....##...#######..#.###.#####.##.#.
.#.#....#.#.....#.#.....#...####..###.......##.#.#...#.....#..#.
.#.#.####.#.#.#.#.#.#####.#....##.....#####..#...#.##..###.#.##.
.#.#.#....##...##.#.#...#.####..###.###...##.#####....#....#....
.#...#...##..#..#...#.#.#.....#...#.....#.....#...##.#..######.#
.##.##......###.###...#.#####.###.#####.#####...#.#..#.#.....#.#
..#..#.####........#..#.........#.#...#.#...#####.#.##...###.#.#
#.#..#....##.#.###..#..########.#.#.#.#.#.#.#...#....####....#..
#.##.#.##.#..#....#..#...#......#...#.#.#.#.#.#.##.#....#.#####.
#..#.#..#.#.#####.##.#.#.#.########.#...#.#...#....####.#...#...
##.#.##.#.##.......#...#.#.#...#..#######.##.######...#.#.#.#.#.
...#....#....#####.#####.#....#.#.#...#...#..#......#.#...#...#.
.###########.#...#.......#..#.#.#...#...####.######.#.#.#.#.#.##
.#.....#....#..#.##..#######..#.#####.###....#....#.###.#.#.#...
.#####.#.##..#.#..##....#...........#.....####.##.#.#...#..####.
.#...#.#...#....#...###...#######.#..####..#....#.#.###..#......
.#.#...###..###.#.#...####........####...#..###.#.#....#.#####..
.#.###....#.#...#.#.#......######......#.##.....#.####.#..#...##
.#.....##.#.#.##..#.##.#####....#.#.###....#.###.####..#....#...
.#####..#.#.#.#..#.....#...#.##.#......###.#.#......#.#########.
.#...##.#.......#..#.#.#.#.#.#..#.####..#..#.#.####.#...#.......
.#.#....#########.#..#...#...#.##.#...#.#.##.#.#..#...#.#.######
.#.#####...#...#....##.#.###.#....#.#...#..#.#..#.#.###...#...#.
.#.......#.#.#.#.#.#...#.....######..#####.#..#.#.###.#######.#.
.########......#...#.###.###....#..#.....#..#...#.....#.....#.#.
.#.....#..#.#....#...#.....####.#.#.#.##.#....#####.#.#.###.....
.#.###.#.#...##..#.###.###....#.#.#..#...####.......#.#....#####
.#...#.##..#...#.#.#.#...#.###..#..#.#.##....#.####.#.####..#...
.###.#.#..####.#.....###..#....#..#..#..#..#......#.#....##.#.#.
.#...#...#.....####...#..#..#.#..#..###.##..#.###.#.####.#....#.
.#.#####.#.####...#.#.#.#..#...#.#.#......#..#....#....#.#.####.
.#.#...#.....#..#...#.#...#..###.....####..#.#.#..##.#.#........
.#.#.#.#.#.#.#.#..###..#.#..#...####.....#...#..#....#..#####.##
.#...#.#.#.#.#.#.#...#.....#..#....#####..##..#.##.#...##...#.#.
.###.#.#...#...#...#.###.#.#.#####.....##...#.#..###.##.#.#.#.#.
.#...###.#.########..#.......#.....###....#.#..#.#...#..#.#...#.
.#.###...#.#.#...#..##.#####.#.#.##...#####..#.#...#.##.#.#####.
.#.#.........#.#.#.#...#...#.#..#...#.....##.#.###.#..#.#.....#.
.#.#.###.###...#.#.#.###.#.#.##.#.#.#.###..#.#......#....#.#....
.#.#.#.....#.##..#.......#...#....#..#...#.#..#####.####...#.###
.#.#.#.###.#..#.######.#########...#.#.#.#.####...#....###.#....
.#.#.#.#.....##...#.#..#.......#.#...#.#.#....#.#.##.#.#...####.
.#.#.#.#.###..###.#.#.##.#####.#.#.##..#.####.#.#..#.#.#.#.#..#.
.#.#.#.#....#.......#..#.#...#...#..#..#......#..#.#.#...#.#.##.
.#.....#.##..##.###.##.#.###.#.####.#.#####.#..#.#...####..#..#.
.#.#####...#..#.#...#......#.#.#....#.#...#.##...#.#.#....#.#...
.#.#....#.#.#...#.########.#.#.#.#....#.#.#..###.#.#.##.##...#.#
.#.#.##.#.#..##.#....#...#...#...#.##...#.##.#...#.#..#.#..#.#..
.#.#..#.#..#..#.####.#.#.#.#######..###.#....#.##...#.#...#..##.
.#.##.#.##.#.#.....#.#.#.#.#.....##.#...######.#..#.#.#####.#...
.#..#.#....#...#.#.#...#.#...#.#....#.#.#...#..#.#.#..#...#...#.
.###############.#.###.#.#####.######.#.#.#.##...#.#.#..#.#####.
.................#.....#......S.......#...#...#.#......#........
