25
S......#.....#..........#
#.####.##.##.#.##.#.#####
..#..#....#..#.#..#..#..#
.##.#######.####.##.###.#
.#......#.#...#......#..#
.#.##.#.#.#.#...#.####.##
.#..#.#.#...#.#.#........
.####.###.###.#.#.##.#.#.
........#.#.#.#...#..###.
#####.#.....#.######.#...
......####.##..#...#.#.#.
.#.##.#....#...##.##.#.#.
.###..#.######..#....###.
##.........#...#..#..#.#.
...#.####.###.######...#.
.###..#.#.#.....#..#...#.
......#.#...##.###.......
###.#...#####..#...######
....#.##.#....##.#..#....
.#.##....#.##....#..#.##.
.#.........#..#####.#..#.
.##.#.###.##....#.....##.
....#........####.##.##..
.#.####.###.##..#...#...#
.#......#....#....###.#.G
