35
...#...#...#.................#.....
.#.#.#.#.#.#.######.##########.###S
.#...#.#.#...#....#....#...#...#...
.#####...####.###.#.##...#.#.##..#.
.....#.#...#......#..#####.#.#..###
####.#.###.#.#..#......#.....##....
.....#.....###.#.#.#.#.#.#####.###.
.###.###.#.#.#....##.#...#.#.#...#.
...#.....#...#..#...#.##...#...#.#.
##.##.##.#####.######..##.####.#.#.
.#.#...#.....#....#..#..#......###.
...#.#.#####.#.##.#.###.#.###....#.
.#...#.......#..#.#.....#...####..#
...#.#..#.####..#.#.#####.#....##..
..#######......##.#.#...#.####..###
.#...#...##..#..#...#.#.#.....#...#
.##.##......###.###...#.#####.###.#
..#..#.####........#..#.........#.#
#.#..#....##.#.###..#..########.#.#
#.##.#.##.#..#....#..#...#......#..
#..#.#..#.#.#####.##.#.#.#.########
##.#.##.#.##.......#...#.#.#...#..#
...#....#....#####.#####.#....#.#.#
.###########.#...#.......#..#.#.#..
.#.....#....#..#.##..#######..#.###
.#####.#.##..#.#..##....#..........
.#...#.#...#....#.....#...#######.#
.#.#...###..###.#.#.#.####........#
.#.###....#.#...#.#.#......######..
.#.....##.#.#.##..#.##.#####....#.#
.#####..#.#.#.#..#.....#...#.##.#..
.#...##.#.......#..#.#.#.#.#.#..#.#
.#.#....#########.#..#...#...#.##.#
##.#####...#...#....##.#.###.#....#
G........#...#...#.#...#.....######
