22
.......##....#........
S.....#......##.#.....
.....##....#.#..#.....
....##.....#...##.....
....#......#####......
....#......##.........
....#.......#.........
....#.......#.........
....#......##.........
...##......##.........
...#........##........
...##........###......
....#..........##.....
....#...........#.....
...##...........#.....
...##..........##.....
....#.........##......
....#.........##......
.#..##.........##.....
.#.##...........##..##
.#...............#..#G
.####...........##..##
