11
..#...#....
.##.#.#.##.
..#.#.#..#.
..#.#.#.##
..#.#.#.#..
G...#...#.S
..#.#.#.#..
..#.#.#.##.
..#.#.#..#.
.##.#.#.##.
..#...#....
