11
..#...#....
..#.#.#.##.
..#.#.#..#.
..#.#.#.##.
..#.#.#.#..
S...#...#.G
..#.#.#.#..
..#.#.#.##.
..#.#.#..#.
..#.#.#.##.
..#...#....
