30
#################.........#.G.
...................###....#...
.....................#.####...
..##################.#........
...................#.#######..
...................#.......#..
################...#.......#..
..............##...#####...#..
..............##.......#...###
..............##.......#......
....######....##.......#......
.........#....##...#...#####..
.........#....##...#.......#..
.........#....##...#.......#..
..####...#....##...######..#..
..#......#..............#..#..
..#......#..............#.....
..#..#######............#.....
..#........#............######
...........##########.........
#########..#........#.........
........#..#........#.........
........#...........#########.
........#...........#.......#.
........#.#######...#.......#.
...#....#..#........#....#..#.
...#.......#........#....#..#.
...#.......##########....#..#.
...#.....................#....
.S.#.....................#....
