30
.........................#...G
.........................#....
.........................#....
....#.....###########....#....
....#.....#..............#....
....#.....#..............#....
....#.....#..............#....
....#.....#......#########....
....#######...................
..............................
..............................
..............................
..............................
...............#.....#########
....#######....#..............
....#..........#..............
....#..........#..............
....#..........#..............
....#..........#..............
....#.....################....
....#.....#..............#....
....#.....#..............#....
....#.....#..............#....
....#.....#..............#....
....#.....#..............#....
#####............#.......#....
.................#............
.................#............
.................#............
S................#............
